draw_date,win_num_1,win_num_2,win_num_3,win_num_4,win_num_5,win_num_6,bonus_num,sum
2002-12-07 00:00:00,10,23,29,33,37,40,16,188
2002-12-14 00:00:00,9,13,21,25,32,42,2,144
2002-12-21 00:00:00,11,16,19,21,27,31,30,155
2002-12-28 00:00:00,14,27,30,31,40,42,2,186
2003-01-04 00:00:00,16,24,29,40,41,42,3,195
2003-01-11 00:00:00,14,15,26,27,40,42,34,198
2003-01-18 00:00:00,2,9,16,25,26,40,42,160
2003-01-25 00:00:00,8,19,25,34,37,39,9,171
2003-02-01 00:00:00,2,4,16,17,36,39,14,128
2003-02-08 00:00:00,9,25,30,33,41,44,6,188
2003-02-15 00:00:00,1,7,36,37,41,42,14,178
2003-02-22 00:00:00,2,11,21,25,39,45,44,187
2003-03-01 00:00:00,22,23,25,37,38,42,26,213
2003-03-08 00:00:00,2,6,12,31,33,40,15,139
2003-03-15 00:00:00,3,4,16,30,31,37,13,134
2003-03-22 00:00:00,6,7,24,37,38,40,33,185
2003-03-29 00:00:00,3,4,9,17,32,37,1,103
2003-04-05 00:00:00,3,12,13,19,32,35,29,143
2003-04-12 00:00:00,6,30,38,39,40,43,26,222
2003-04-19 00:00:00,10,14,18,20,23,30,41,156
2003-04-26 00:00:00,6,12,17,18,31,32,21,137
2003-05-03 00:00:00,4,5,6,8,17,39,25,104
2003-05-10 00:00:00,5,13,17,18,33,42,44,172
2003-05-17 00:00:00,7,8,27,29,36,43,6,156
2003-05-24 00:00:00,2,4,21,26,43,44,16,156
2003-05-31 00:00:00,4,5,7,18,20,25,31,110
2003-06-07 00:00:00,1,20,26,28,37,43,27,182
2003-06-14 00:00:00,9,18,23,25,35,37,1,148
2003-06-21 00:00:00,1,5,13,34,39,40,11,143
2003-06-28 00:00:00,8,17,20,35,36,44,4,164
2003-07-05 00:00:00,7,9,18,23,28,35,32,152
2003-07-12 00:00:00,6,14,19,25,34,44,11,153
2003-07-19 00:00:00,4,7,32,33,40,41,9,166
2003-07-26 00:00:00,9,26,35,37,40,42,2,191
2003-08-02 00:00:00,2,3,11,26,37,43,39,161
2003-08-09 00:00:00,1,10,23,26,28,40,31,159
2003-08-16 00:00:00,7,27,30,33,35,37,42,211
2003-08-23 00:00:00,16,17,22,30,37,43,36,201
2003-08-30 00:00:00,6,7,13,15,21,43,8,113
2003-09-06 00:00:00,7,13,18,19,25,26,6,114
2003-09-13 00:00:00,13,20,23,35,38,43,34,206
2003-09-20 00:00:00,17,18,19,21,23,32,1,131
2003-09-27 00:00:00,6,31,35,38,39,44,1,194
2003-10-04 00:00:00,3,11,21,30,38,45,39,187
2003-10-11 00:00:00,1,10,20,27,33,35,17,143
2003-10-18 00:00:00,8,13,15,23,31,38,39,167
2003-10-25 00:00:00,14,17,26,31,36,45,27,196
2003-11-01 00:00:00,6,10,18,26,37,38,3,138
2003-11-08 00:00:00,4,7,16,19,33,40,30,149
2003-11-15 00:00:00,2,10,12,15,22,44,1,106
2003-11-22 00:00:00,2,3,11,16,26,44,35,137
2003-11-29 00:00:00,2,4,15,16,20,29,1,87
2003-12-06 00:00:00,7,8,14,32,33,39,42,175
2003-12-13 00:00:00,1,8,21,27,36,39,37,169
2003-12-20 00:00:00,17,21,31,37,40,44,7,197
2003-12-27 00:00:00,10,14,30,31,33,37,19,174
2004-01-03 00:00:00,7,10,16,25,29,44,6,137
2004-01-10 00:00:00,10,24,25,33,40,44,1,177
2004-01-17 00:00:00,6,29,36,39,41,45,13,209
2004-01-24 00:00:00,2,8,25,36,39,42,11,163
2004-01-31 00:00:00,14,15,19,30,38,43,8,167
2004-02-07 00:00:00,3,8,15,27,29,35,21,138
2004-02-14 00:00:00,3,20,23,36,38,40,5,165
2004-02-21 00:00:00,14,15,18,21,26,36,39,169
2004-02-28 00:00:00,4,25,33,36,40,43,39,220
2004-03-06 00:00:00,2,3,7,17,22,24,45,120
2004-03-13 00:00:00,3,7,10,15,36,38,33,142
2004-03-20 00:00:00,10,12,15,16,26,39,38,156
2004-03-27 00:00:00,5,8,14,15,19,39,35,135
2004-04-03 00:00:00,5,19,22,25,28,43,26,168
2004-04-10 00:00:00,5,9,12,16,29,41,21,133
2004-04-17 00:00:00,2,4,11,17,26,27,1,88
2004-04-24 00:00:00,3,12,18,32,40,43,38,186
2004-05-01 00:00:00,6,15,17,18,35,40,23,154
2004-05-08 00:00:00,2,5,24,32,34,44,28,169
2004-05-15 00:00:00,1,3,15,22,25,37,43,146
2004-05-22 00:00:00,2,18,29,32,43,44,37,205
2004-05-29 00:00:00,10,13,25,29,33,35,38,183
2004-06-05 00:00:00,3,12,24,27,30,32,14,142
2004-06-12 00:00:00,17,18,24,25,26,30,1,141
2004-06-19 00:00:00,5,7,11,13,20,33,6,95
2004-06-26 00:00:00,1,2,3,14,27,42,39,128
2004-07-03 00:00:00,6,10,15,17,19,34,14,115
2004-07-10 00:00:00,16,23,27,34,42,45,11,198
2004-07-17 00:00:00,6,8,13,23,31,36,21,138
2004-07-24 00:00:00,2,12,37,39,41,45,33,209
2004-07-31 00:00:00,4,12,16,23,34,43,26,158
2004-08-07 00:00:00,1,17,20,24,30,41,27,160
2004-08-14 00:00:00,4,26,28,29,33,40,37,197
2004-08-21 00:00:00,17,20,29,35,38,44,10,193
2004-08-28 00:00:00,1,21,24,26,29,42,27,170
2004-09-04 00:00:00,3,14,24,33,35,36,17,162
2004-09-11 00:00:00,6,22,24,36,38,44,19,189
2004-09-18 00:00:00,5,32,34,40,41,45,6,203
2004-09-25 00:00:00,8,17,27,31,34,43,14,174
2004-10-02 00:00:00,1,3,8,21,22,31,20,106
2004-10-09 00:00:00,6,7,14,15,20,36,3,101
2004-10-16 00:00:00,6,9,16,23,24,32,43,153
2004-10-23 00:00:00,1,3,10,27,29,37,11,118
2004-10-30 00:00:00,1,7,11,23,37,42,6,127
2004-11-06 00:00:00,1,3,17,32,35,45,8,141
2004-11-13 00:00:00,17,22,24,26,35,40,42,206
2004-11-20 00:00:00,5,14,15,27,30,45,10,146
2004-11-27 00:00:00,17,32,33,34,42,44,35,237
2004-12-04 00:00:00,8,10,20,34,41,45,28,186
2004-12-11 00:00:00,4,10,12,22,24,33,29,134
2004-12-18 00:00:00,1,4,5,6,9,31,17,73
2004-12-25 00:00:00,7,18,22,23,29,44,12,155
2005-01-01 00:00:00,1,5,34,36,42,44,33,195
2005-01-08 00:00:00,7,20,22,23,29,43,1,145
2005-01-15 00:00:00,7,18,31,33,36,40,27,192
2005-01-22 00:00:00,26,29,30,33,41,42,43,244
2005-01-29 00:00:00,4,9,28,33,36,45,26,181
2005-02-05 00:00:00,11,14,19,26,28,41,2,141
2005-02-12 00:00:00,1,2,6,9,25,28,31,102
2005-02-19 00:00:00,2,4,25,31,34,37,17,150
2005-02-26 00:00:00,5,10,22,34,36,44,35,186
2005-03-05 00:00:00,3,4,10,17,19,22,38,113
2005-03-12 00:00:00,3,11,13,14,17,21,38,117
2005-03-19 00:00:00,4,6,10,11,32,37,30,130
2005-03-26 00:00:00,12,28,30,34,38,43,9,194
2005-04-02 00:00:00,1,11,16,17,36,40,8,129
2005-04-09 00:00:00,7,17,18,28,30,45,27,172
2005-04-16 00:00:00,4,16,23,25,29,42,1,140
2005-04-23 00:00:00,2,8,32,33,35,36,18,164
2005-04-30 00:00:00,7,20,22,27,40,43,1,160
2005-05-07 00:00:00,3,5,10,29,32,43,35,157
2005-05-14 00:00:00,12,30,34,36,37,45,39,233
2005-05-21 00:00:00,19,23,25,28,38,42,17,192
2005-05-28 00:00:00,7,19,24,27,42,45,31,195
2005-06-04 00:00:00,8,10,11,14,15,21,37,116
2005-06-11 00:00:00,3,17,23,34,41,45,43,206
2005-06-18 00:00:00,4,7,15,18,23,26,13,106
2005-06-25 00:00:00,3,12,20,23,31,35,43,167
2005-07-02 00:00:00,6,14,22,28,35,39,16,160
2005-07-09 00:00:00,2,16,30,36,41,42,11,178
2005-07-16 00:00:00,7,9,20,25,36,39,15,151
2005-07-23 00:00:00,10,11,27,28,37,39,19,171
2005-07-30 00:00:00,9,11,15,20,28,43,13,139
2005-08-06 00:00:00,3,13,17,18,19,28,8,106
2005-08-13 00:00:00,8,12,29,31,42,43,2,167
2005-08-20 00:00:00,12,16,30,34,40,44,19,195
2005-08-27 00:00:00,26,27,28,42,43,45,8,219
2005-09-03 00:00:00,4,15,17,26,36,37,43,178
2005-09-10 00:00:00,2,3,13,20,27,44,9,118
2005-09-17 00:00:00,2,19,27,35,41,42,25,191
2005-09-24 00:00:00,4,6,13,21,40,42,36,162
2005-10-01 00:00:00,21,25,33,34,35,36,17,201
2005-10-08 00:00:00,2,11,21,34,41,42,27,178
2005-10-15 00:00:00,2,18,25,28,37,39,16,165
2005-10-22 00:00:00,1,2,10,13,18,19,15,78
2005-10-29 00:00:00,1,5,13,26,29,34,43,151
2005-11-05 00:00:00,3,8,11,12,13,36,33,116
2005-11-12 00:00:00,6,19,21,35,40,45,20,186
2005-11-19 00:00:00,16,19,20,32,33,41,4,165
2005-11-26 00:00:00,5,18,28,30,42,45,2,170
2005-12-03 00:00:00,19,26,30,33,35,39,37,219
2005-12-10 00:00:00,4,9,13,18,21,34,7,106
2005-12-17 00:00:00,1,18,30,41,42,43,32,207
2005-12-24 00:00:00,3,7,8,34,39,41,1,133
2005-12-31 00:00:00,22,34,36,40,42,45,44,263
2006-01-07 00:00:00,1,5,21,25,38,41,24,155
2006-01-14 00:00:00,7,11,26,28,29,44,16,161
2006-01-21 00:00:00,6,9,10,11,39,41,27,143
2006-01-28 00:00:00,5,13,18,19,22,42,31,150
2006-02-04 00:00:00,9,12,27,36,39,45,14,182
2006-02-11 00:00:00,24,27,28,30,36,39,4,188
2006-02-18 00:00:00,3,10,31,40,42,43,30,199
2006-02-25 00:00:00,16,27,35,37,43,45,19,222
2006-03-04 00:00:00,2,11,13,15,31,42,10,124
2006-03-11 00:00:00,4,16,25,29,34,35,1,144
2006-03-18 00:00:00,4,19,21,24,26,41,35,170
2006-03-25 00:00:00,3,9,24,30,33,34,18,151
2006-04-01 00:00:00,13,14,18,22,35,39,16,157
2006-04-08 00:00:00,19,26,28,31,33,36,17,190
2006-04-15 00:00:00,4,17,30,32,33,34,15,165
2006-04-22 00:00:00,1,10,13,16,37,43,6,126
2006-04-29 00:00:00,1,5,11,12,18,23,9,79
2006-05-06 00:00:00,5,9,17,25,39,43,32,170
2006-05-13 00:00:00,2,15,20,21,29,34,22,143
2006-05-20 00:00:00,14,21,23,32,40,45,44,219
2006-05-27 00:00:00,13,15,27,29,34,40,35,193
2006-06-03 00:00:00,2,18,24,34,40,42,5,165
2006-06-10 00:00:00,1,2,6,16,20,33,41,119
2006-06-17 00:00:00,1,2,4,8,19,38,14,86
2006-06-24 00:00:00,4,10,14,19,21,45,9,122
2006-07-01 00:00:00,1,2,8,18,29,38,42,138
2006-07-08 00:00:00,19,24,27,30,31,34,36,201
2006-07-15 00:00:00,8,14,32,35,37,45,28,199
2006-07-22 00:00:00,8,14,18,30,31,44,15,160
2006-07-29 00:00:00,5,6,24,25,32,37,8,137
2006-08-05 00:00:00,4,8,11,18,37,45,33,156
2006-08-12 00:00:00,6,14,18,26,36,39,13,152
2006-08-19 00:00:00,15,20,23,26,39,44,28,195
2006-08-26 00:00:00,7,10,19,22,35,40,31,164
2006-09-02 00:00:00,35,36,37,41,44,45,30,268
2006-09-09 00:00:00,7,12,16,34,42,45,4,160
2006-09-16 00:00:00,12,19,20,25,41,45,2,164
2006-09-23 00:00:00,14,21,22,25,30,36,43,191
2006-09-30 00:00:00,5,6,13,14,17,20,7,82
2006-10-07 00:00:00,3,11,24,38,39,44,26,185
2006-10-14 00:00:00,12,14,27,33,39,44,17,186
2006-10-21 00:00:00,1,3,11,24,30,32,7,108
2006-10-28 00:00:00,3,12,14,35,40,45,5,154
2006-11-04 00:00:00,1,3,21,29,35,37,30,156
2006-11-11 00:00:00,1,2,3,15,20,25,43,109
2006-11-18 00:00:00,3,11,14,31,32,37,38,166
2006-11-25 00:00:00,14,25,31,34,40,44,24,212
2006-12-02 00:00:00,2,7,18,20,24,33,37,141
2006-12-09 00:00:00,10,19,22,23,25,37,39,175
2006-12-16 00:00:00,12,13,17,20,33,41,8,144
2006-12-23 00:00:00,11,12,18,21,31,38,8,139
2006-12-30 00:00:00,2,3,4,5,20,24,42,100
2007-01-06 00:00:00,5,7,20,25,28,37,32,154
2007-01-13 00:00:00,2,3,7,15,43,44,4,118
2007-01-20 00:00:00,7,16,17,33,36,40,1,150
2007-01-27 00:00:00,16,20,27,33,35,39,38,208
2007-02-03 00:00:00,1,8,14,18,29,44,20,134
2007-02-10 00:00:00,4,11,20,26,35,37,16,149
2007-02-17 00:00:00,5,11,19,21,34,43,31,164
2007-02-24 00:00:00,2,20,33,35,37,40,10,177
2007-03-03 00:00:00,5,7,28,29,39,43,44,195
2007-03-10 00:00:00,1,3,18,20,26,27,38,133
2007-03-17 00:00:00,4,19,26,27,30,42,7,155
2007-03-24 00:00:00,5,11,13,19,31,36,7,122
2007-03-31 00:00:00,2,6,8,14,21,22,34,107
2007-04-07 00:00:00,4,5,15,16,22,42,2,106
2007-04-14 00:00:00,17,25,35,36,39,44,23,219
2007-04-21 00:00:00,4,5,9,11,23,38,35,125
2007-04-28 00:00:00,5,11,14,29,32,33,12,136
2007-05-05 00:00:00,5,10,19,31,44,45,27,181
2007-05-12 00:00:00,8,9,10,12,24,44,35,142
2007-05-19 00:00:00,4,6,13,17,28,40,39,147
2007-05-26 00:00:00,13,21,22,24,26,37,4,147
2007-06-02 00:00:00,21,22,26,27,31,37,8,172
2007-06-09 00:00:00,1,4,8,13,37,39,7,109
2007-06-16 00:00:00,1,11,17,21,24,44,33,151
2007-06-23 00:00:00,2,4,15,28,31,34,35,149
2007-06-30 00:00:00,11,15,24,39,41,44,7,181
2007-07-07 00:00:00,6,10,16,40,41,43,21,177
2007-07-14 00:00:00,2,16,24,27,28,35,21,153
2007-07-21 00:00:00,4,19,20,21,32,34,43,173
2007-07-28 00:00:00,2,12,17,19,28,42,34,154
2007-08-04 00:00:00,13,16,25,36,37,38,19,184
2007-08-11 00:00:00,9,11,27,31,32,38,22,170
2007-08-18 00:00:00,13,18,21,23,26,39,15,155
2007-08-25 00:00:00,12,15,28,36,39,40,13,183
2007-09-01 00:00:00,3,8,17,23,38,45,13,147
2007-09-08 00:00:00,3,8,27,31,41,44,11,165
2007-09-15 00:00:00,19,23,30,37,43,45,38,235
2007-09-22 00:00:00,6,7,19,25,28,38,45,168
2007-09-29 00:00:00,14,23,26,31,39,45,28,206
2007-10-06 00:00:00,8,19,25,31,34,36,33,186
2007-10-13 00:00:00,1,5,19,20,24,30,27,126
2007-10-20 00:00:00,1,5,6,24,27,42,32,137
2007-10-27 00:00:00,4,11,14,21,23,43,32,148
2007-11-03 00:00:00,6,13,27,31,32,37,4,150
2007-11-10 00:00:00,14,27,30,31,38,40,17,197
2007-11-17 00:00:00,4,5,14,35,42,45,34,179
2007-11-24 00:00:00,7,12,15,24,37,40,43,178
2007-12-01 00:00:00,6,11,16,18,31,43,2,127
2007-12-08 00:00:00,9,12,24,25,29,31,36,166
2007-12-15 00:00:00,1,27,28,32,37,40,18,183
2007-12-22 00:00:00,9,16,27,36,41,44,5,178
2007-12-29 00:00:00,5,9,34,37,38,39,12,174
2008-01-05 00:00:00,3,4,9,11,22,42,37,128
2008-01-12 00:00:00,7,8,24,34,36,41,1,151
2008-01-19 00:00:00,3,10,19,24,32,45,12,145
2008-01-26 00:00:00,5,18,20,36,42,43,32,196
2008-02-02 00:00:00,5,9,12,20,21,26,27,120
2008-02-09 00:00:00,3,8,9,27,29,40,36,152
2008-02-16 00:00:00,7,9,12,27,39,43,28,165
2008-02-23 00:00:00,1,8,24,31,34,44,6,148
2008-03-01 00:00:00,13,14,15,26,35,39,25,167
2008-03-08 00:00:00,14,19,20,35,38,40,26,192
2008-03-15 00:00:00,4,15,21,33,39,41,25,178
2008-03-22 00:00:00,10,12,13,15,25,29,20,124
2008-03-29 00:00:00,3,11,37,39,41,43,13,187
2008-04-05 00:00:00,7,16,31,36,37,38,11,176
2008-04-12 00:00:00,10,11,23,24,36,37,35,176
2008-04-19 00:00:00,1,3,4,6,14,41,12,81
2008-04-26 00:00:00,2,5,10,18,31,32,30,128
2008-05-03 00:00:00,6,8,18,31,38,45,42,188
2008-05-10 00:00:00,2,7,15,24,30,45,28,151
2008-05-17 00:00:00,13,33,37,40,41,45,2,211
2008-05-24 00:00:00,1,15,19,40,42,44,17,178
2008-05-31 00:00:00,6,12,24,27,35,37,41,182
2008-06-07 00:00:00,1,12,17,28,35,41,10,144
2008-06-14 00:00:00,3,14,33,37,38,42,10,177
2008-06-21 00:00:00,8,13,18,32,39,45,7,162
2008-06-28 00:00:00,3,7,8,18,20,42,45,143
2008-07-05 00:00:00,17,18,31,32,33,34,10,175
2008-07-12 00:00:00,1,9,17,21,29,33,24,134
2008-07-19 00:00:00,6,10,17,30,37,38,40,178
2008-07-26 00:00:00,1,4,12,16,18,38,8,97
2008-08-02 00:00:00,3,8,15,27,30,45,44,172
2008-08-09 00:00:00,6,11,19,20,28,32,34,150
2008-08-16 00:00:00,5,9,27,29,37,40,19,166
2008-08-23 00:00:00,1,3,20,25,36,45,24,154
2008-08-30 00:00:00,7,9,10,12,26,38,39,141
2008-09-06 00:00:00,7,11,13,33,37,43,26,170
2008-09-13 00:00:00,13,19,20,32,38,42,4,168
2008-09-20 00:00:00,2,14,17,30,38,45,43,189
2008-09-27 00:00:00,4,10,16,26,33,41,38,168
2008-10-04 00:00:00,7,8,18,21,23,39,9,125
2008-10-11 00:00:00,4,18,23,30,34,41,19,169
2008-10-18 00:00:00,5,15,21,23,25,45,12,146
2008-10-25 00:00:00,14,15,17,19,37,45,40,187
2008-11-01 00:00:00,1,2,5,11,18,36,22,95
2008-11-08 00:00:00,1,5,19,28,34,41,16,144
2008-11-15 00:00:00,4,12,24,27,28,32,10,137
2008-11-22 00:00:00,2,3,5,6,12,20,25,73
2008-11-29 00:00:00,9,17,34,35,43,45,2,185
2008-12-06 00:00:00,15,17,19,34,38,41,2,166
2008-12-13 00:00:00,1,13,33,35,43,45,23,193
2008-12-20 00:00:00,10,11,21,27,31,39,43,182
2008-12-27 00:00:00,3,10,11,22,36,39,8,129
2009-01-03 00:00:00,2,17,19,20,34,45,21,158
2009-01-10 00:00:00,5,8,22,28,33,42,37,175
2009-01-17 00:00:00,16,19,23,25,41,45,3,172
2009-01-24 00:00:00,12,18,20,21,25,34,42,172
2009-01-31 00:00:00,9,18,29,32,38,43,20,189
2009-02-07 00:00:00,10,14,15,32,36,42,3,152
2009-02-14 00:00:00,2,4,21,25,33,36,17,138
2009-02-21 00:00:00,7,17,20,32,44,45,33,198
2009-02-28 00:00:00,16,23,25,33,36,39,40,212
2009-03-07 00:00:00,6,12,13,17,32,44,24,148
2009-03-14 00:00:00,1,6,9,16,17,28,24,101
2009-03-21 00:00:00,9,17,19,30,35,42,4,156
2009-03-28 00:00:00,3,4,16,17,19,20,23,102
2009-04-04 00:00:00,4,9,14,26,31,44,39,167
2009-04-11 00:00:00,16,17,34,36,42,45,3,193
2009-04-18 00:00:00,5,14,27,30,39,43,35,193
2009-04-25 00:00:00,13,15,21,29,39,43,33,193
2009-05-02 00:00:00,5,9,16,23,26,45,21,145
2009-05-09 00:00:00,3,5,20,34,35,44,16,157
2009-05-16 00:00:00,1,5,14,18,32,37,4,111
2009-05-23 00:00:00,2,13,34,38,42,45,16,190
2009-05-30 00:00:00,6,8,14,21,30,37,45,161
2009-06-06 00:00:00,18,24,26,29,34,38,32,201
2009-06-13 00:00:00,1,8,19,34,39,43,41,185
2009-06-20 00:00:00,1,13,14,33,34,43,25,163
2009-06-27 00:00:00,1,10,17,29,31,43,15,146
2009-07-04 00:00:00,1,2,15,28,34,45,38,163
2009-07-11 00:00:00,15,20,23,29,39,42,2,170
2009-07-18 00:00:00,5,13,14,22,44,45,33,176
2009-07-25 00:00:00,3,8,13,27,32,42,10,135
2009-08-01 00:00:00,3,14,17,20,24,31,34,143
2009-08-08 00:00:00,5,13,14,20,24,25,36,137
2009-08-15 00:00:00,1,8,18,24,29,33,35,148
2009-08-22 00:00:00,5,25,27,29,34,36,33,189
2009-08-29 00:00:00,5,16,17,20,26,41,24,149
2009-09-05 00:00:00,11,16,19,22,29,36,26,159
2009-09-12 00:00:00,14,19,36,43,44,45,1,202
2009-09-19 00:00:00,5,8,29,30,35,44,38,189
2009-09-26 00:00:00,2,8,14,25,29,45,24,147
2009-10-03 00:00:00,10,14,18,21,36,37,5,141
2009-10-10 00:00:00,1,9,10,12,21,40,37,130
2009-10-17 00:00:00,1,10,19,20,24,40,23,137
2009-10-24 00:00:00,4,16,23,25,35,40,27,170
2009-10-31 00:00:00,5,10,16,24,27,35,33,150
2009-11-07 00:00:00,2,3,22,27,30,40,29,153
2009-11-14 00:00:00,11,12,14,21,32,38,6,134
2009-11-21 00:00:00,2,5,7,14,16,40,4,88
2009-11-28 00:00:00,5,15,21,25,26,30,31,153
2009-12-05 00:00:00,5,12,19,26,27,44,38,171
2009-12-12 00:00:00,3,22,25,29,32,44,19,174
2009-12-19 00:00:00,11,21,24,30,39,45,26,196
2009-12-26 00:00:00,17,20,35,36,41,43,21,213
2010-01-02 00:00:00,16,18,24,42,44,45,17,206
2010-01-09 00:00:00,7,9,15,26,27,42,18,144
2010-01-16 00:00:00,8,11,14,16,18,21,13,101
2010-01-23 00:00:00,15,26,37,42,43,45,9,217
2010-01-30 00:00:00,11,13,15,17,25,34,26,141
2010-02-06 00:00:00,4,8,19,25,27,45,7,135
2010-02-13 00:00:00,1,11,13,24,28,40,7,124
2010-02-20 00:00:00,6,22,29,37,43,45,23,205
2010-02-27 00:00:00,5,22,29,31,34,39,43,203
2010-03-06 00:00:00,6,10,22,31,35,40,19,163
2010-03-13 00:00:00,1,2,8,17,26,37,27,118
2010-03-20 00:00:00,1,5,10,12,16,20,11,75
2010-03-27 00:00:00,10,15,22,24,27,42,19,159
2010-04-03 00:00:00,4,15,28,33,37,40,25,182
2010-04-10 00:00:00,11,22,24,32,36,38,7,170
2010-04-17 00:00:00,7,12,19,21,29,32,9,129
2010-04-24 00:00:00,4,7,10,19,31,40,26,137
2010-05-01 00:00:00,1,26,31,34,40,43,20,195
2010-05-08 00:00:00,1,8,9,17,29,32,45,141
2010-05-15 00:00:00,7,16,18,20,23,26,3,113
2010-05-22 00:00:00,16,17,28,37,39,40,15,192
2010-05-29 00:00:00,10,11,18,22,28,39,30,158
2010-06-05 00:00:00,1,3,7,8,24,42,43,128
2010-06-12 00:00:00,9,16,28,40,41,43,21,198
2010-06-19 00:00:00,1,13,20,22,25,28,15,124
2010-06-26 00:00:00,11,15,20,26,31,35,7,145
2010-07-03 00:00:00,18,20,31,34,40,45,30,218
2010-07-10 00:00:00,12,13,17,22,25,33,8,130
2010-07-17 00:00:00,10,15,20,23,42,44,7,161
2010-07-24 00:00:00,1,2,9,17,19,42,20,110
2010-07-31 00:00:00,9,21,27,34,41,43,2,177
2010-08-07 00:00:00,6,12,18,31,38,43,9,157
2010-08-14 00:00:00,5,9,15,19,22,36,32,138
2010-08-21 00:00:00,10,14,22,24,28,37,26,161
2010-08-28 00:00:00,5,20,21,24,33,40,36,179
2010-09-04 00:00:00,1,2,10,25,26,44,4,112
2010-09-11 00:00:00,7,12,21,24,27,36,45,172
2010-09-18 00:00:00,6,7,13,16,24,25,1,92
2010-09-25 00:00:00,9,20,21,22,30,37,16,155
2010-10-02 00:00:00,6,9,21,31,32,40,38,177
2010-10-09 00:00:00,1,3,18,32,40,41,16,151
2010-10-16 00:00:00,11,14,22,35,37,39,5,163
2010-10-23 00:00:00,4,7,39,41,42,45,40,218
2010-10-30 00:00:00,2,9,15,23,34,40,3,126
2010-11-06 00:00:00,2,14,15,22,23,44,43,163
2010-11-13 00:00:00,7,17,20,26,30,40,24,164
2010-11-20 00:00:00,5,6,8,11,22,26,44,122
2010-11-27 00:00:00,4,5,14,20,22,43,44,152
2010-12-04 00:00:00,11,13,15,26,28,34,31,158
2010-12-11 00:00:00,2,11,13,14,28,30,7,105
2010-12-18 00:00:00,4,9,10,29,31,34,27,144
2010-12-25 00:00:00,6,11,26,27,28,44,30,172
2011-01-01 00:00:00,8,15,19,21,34,44,12,153
2011-01-08 00:00:00,1,17,27,28,29,40,5,147
2011-01-15 00:00:00,10,11,26,31,34,44,30,186
2011-01-22 00:00:00,8,10,14,27,33,38,3,133
2011-01-29 00:00:00,4,17,18,27,39,43,19,167
2011-02-05 00:00:00,6,7,15,24,28,30,21,131
2011-02-12 00:00:00,12,16,19,22,37,40,8,154
2011-02-19 00:00:00,3,23,28,34,39,42,16,185
2011-02-26 00:00:00,1,3,16,18,30,34,44,146
2011-03-05 00:00:00,18,22,25,31,38,45,6,185
2011-03-12 00:00:00,2,3,5,11,27,39,33,120
2011-03-19 00:00:00,19,23,29,33,35,43,27,209
2011-03-26 00:00:00,3,13,20,24,33,37,35,165
2011-04-02 00:00:00,8,16,26,30,38,45,42,205
2011-04-09 00:00:00,9,14,20,22,33,34,28,160
2011-04-16 00:00:00,11,16,29,38,41,44,21,200
2011-04-23 00:00:00,6,12,20,26,29,38,45,176
2011-04-30 00:00:00,17,20,30,31,37,40,25,200
2011-05-07 00:00:00,10,22,28,34,36,44,2,176
2011-05-14 00:00:00,1,23,28,30,34,35,9,160
2011-05-21 00:00:00,25,27,29,36,38,40,41,236
2011-05-28 00:00:00,4,6,10,19,20,44,14,117
2011-06-04 00:00:00,11,13,23,35,43,45,17,187
2011-06-11 00:00:00,13,20,21,30,39,45,32,200
2011-06-18 00:00:00,1,11,12,14,26,35,6,105
2011-06-25 00:00:00,2,7,8,9,17,33,34,110
2011-07-02 00:00:00,3,7,13,27,40,41,36,167
2011-07-09 00:00:00,3,10,20,26,35,43,36,173
2011-07-16 00:00:00,6,14,19,21,23,31,13,127
2011-07-23 00:00:00,12,15,20,24,30,38,29,168
2011-07-30 00:00:00,8,10,18,30,32,34,27,159
2011-08-06 00:00:00,12,24,33,38,40,42,30,219
2011-08-13 00:00:00,13,25,27,34,38,41,10,188
2011-08-20 00:00:00,4,19,20,26,30,35,24,158
2011-08-27 00:00:00,1,7,12,18,23,27,44,132
2011-09-03 00:00:00,8,10,18,23,27,40,33,159
2011-09-10 00:00:00,4,9,10,32,36,40,18,149
2011-09-17 00:00:00,4,6,10,14,25,40,12,111
2011-09-24 00:00:00,8,11,28,30,43,45,41,206
2011-10-01 00:00:00,11,18,26,31,37,40,43,206
2011-10-08 00:00:00,3,20,24,32,37,45,4,165
2011-10-15 00:00:00,23,29,31,33,34,44,40,234
2011-10-22 00:00:00,6,12,15,34,42,44,4,157
2011-10-29 00:00:00,1,8,11,13,22,38,31,124
2011-11-05 00:00:00,4,10,13,23,32,44,20,146
2011-11-12 00:00:00,2,12,14,17,24,40,39,148
2011-11-19 00:00:00,8,13,15,28,37,43,17,161
2011-11-26 00:00:00,4,21,22,34,37,38,33,189
2011-12-03 00:00:00,10,16,20,39,41,42,27,195
2011-12-10 00:00:00,6,13,29,37,39,41,43,208
2011-12-17 00:00:00,16,25,26,31,36,43,44,221
2011-12-24 00:00:00,8,13,20,22,23,36,34,156
2011-12-31 00:00:00,4,13,18,31,33,45,43,187
2012-01-07 00:00:00,1,9,14,16,21,29,3,93
2012-01-14 00:00:00,9,12,13,15,37,38,27,151
2012-01-21 00:00:00,14,25,29,32,33,45,37,215
2012-01-28 00:00:00,18,29,30,37,39,43,8,204
2012-02-04 00:00:00,8,23,25,27,35,44,24,186
2012-02-11 00:00:00,3,5,10,17,30,31,16,112
2012-02-18 00:00:00,3,4,23,29,40,41,20,160
2012-02-25 00:00:00,1,10,16,24,25,35,43,154
2012-03-03 00:00:00,12,15,19,22,28,34,5,135
2012-03-10 00:00:00,1,3,27,28,32,45,11,147
2012-03-17 00:00:00,17,22,26,27,36,39,20,187
2012-03-24 00:00:00,1,2,23,25,38,40,43,172
2012-03-31 00:00:00,4,8,25,27,37,41,21,163
2012-04-07 00:00:00,2,8,17,30,31,38,25,151
2012-04-14 00:00:00,2,4,8,15,20,27,11,87
2012-04-21 00:00:00,2,7,26,29,40,43,42,189
2012-04-28 00:00:00,8,17,35,36,39,42,4,181
2012-05-05 00:00:00,22,27,31,35,37,40,42,234
2012-05-12 00:00:00,20,22,26,33,36,37,25,199
2012-05-19 00:00:00,5,7,8,15,30,43,22,130
2012-05-26 00:00:00,4,13,22,27,34,44,6,150
2012-06-02 00:00:00,4,13,20,29,36,41,39,182
2012-06-09 00:00:00,19,20,23,24,43,44,13,186
2012-06-16 00:00:00,13,14,24,32,39,41,3,166
2012-06-23 00:00:00,5,20,23,27,35,40,43,193
2012-06-30 00:00:00,3,4,12,20,24,34,41,138
2012-07-07 00:00:00,1,4,10,17,31,42,2,107
2012-07-14 00:00:00,6,22,28,32,34,40,26,188
2012-07-21 00:00:00,1,5,27,30,34,36,40,173
2012-07-28 00:00:00,6,14,22,26,43,44,31,186
2012-08-04 00:00:00,7,20,22,25,38,40,44,196
2012-08-11 00:00:00,6,9,11,22,24,30,31,133
2012-08-18 00:00:00,12,13,32,33,40,41,4,175
2012-08-25 00:00:00,5,27,31,34,35,43,37,212
2012-09-01 00:00:00,12,25,29,35,42,43,24,210
2012-09-08 00:00:00,12,29,32,33,39,40,42,227
2012-09-15 00:00:00,3,7,14,23,26,42,24,139
2012-09-22 00:00:00,4,5,9,13,26,27,1,85
2012-09-29 00:00:00,5,8,21,23,27,33,12,129
2012-10-06 00:00:00,1,15,20,26,35,42,9,148
2012-10-13 00:00:00,2,11,12,15,23,37,8,108
2012-10-20 00:00:00,2,8,23,41,43,44,30,191
2012-10-27 00:00:00,1,9,12,28,36,41,10,137
2012-11-03 00:00:00,14,23,30,32,34,38,6,177
2012-11-10 00:00:00,6,8,13,16,30,43,3,119
2012-11-17 00:00:00,4,22,27,28,38,40,1,160
2012-11-24 00:00:00,3,7,18,29,32,36,19,144
2012-12-01 00:00:00,4,5,13,14,37,41,11,125
2012-12-08 00:00:00,1,4,37,38,40,45,7,172
2012-12-15 00:00:00,10,11,29,38,41,45,21,195
2012-12-22 00:00:00,11,23,26,29,39,44,22,194
2012-12-29 00:00:00,7,14,17,20,35,39,31,163
2013-01-05 00:00:00,1,12,22,32,33,42,38,180
2013-01-12 00:00:00,5,17,25,31,39,40,10,167
2013-01-19 00:00:00,18,20,24,27,31,42,39,201
2013-01-26 00:00:00,16,23,27,29,33,41,22,191
2013-02-02 00:00:00,1,5,9,21,27,35,45,143
2013-02-09 00:00:00,16,17,23,24,29,44,3,156
2013-02-16 00:00:00,9,14,15,17,31,33,23,142
2013-02-23 00:00:00,10,24,26,29,37,38,32,196
2013-03-02 00:00:00,11,12,14,15,18,39,34,143
2013-03-09 00:00:00,7,8,18,32,37,43,12,157
2013-03-16 00:00:00,12,23,26,30,36,43,11,181
2013-03-23 00:00:00,6,10,18,31,32,34,11,142
2013-03-30 00:00:00,3,19,22,31,42,43,26,186
2013-04-06 00:00:00,3,12,13,15,34,36,14,127
2013-04-13 00:00:00,8,13,26,28,32,34,43,184
2013-04-20 00:00:00,5,6,19,26,41,45,34,176
2013-04-27 00:00:00,13,18,26,31,34,44,12,178
2013-05-04 00:00:00,5,17,21,25,36,44,10,158
2013-05-11 00:00:00,4,24,25,27,34,35,2,151
2013-05-18 00:00:00,8,17,20,27,37,43,6,158
2013-05-25 00:00:00,6,7,15,22,34,39,28,151
2013-06-01 00:00:00,1,12,13,21,32,45,14,138
2013-06-08 00:00:00,29,31,35,38,40,44,17,234
2013-06-15 00:00:00,1,7,14,20,34,37,41,154
2013-06-22 00:00:00,3,6,20,24,27,44,25,149
2013-06-29 00:00:00,1,10,20,32,35,40,43,181
2013-07-06 00:00:00,2,7,17,28,29,39,37,159
2013-07-13 00:00:00,13,14,17,32,41,42,6,165
2013-07-20 00:00:00,11,17,21,24,26,36,12,147
2013-07-27 00:00:00,12,20,23,28,30,44,43,200
2013-08-03 00:00:00,4,20,26,28,35,40,31,184
2013-08-10 00:00:00,12,15,19,26,40,43,29,184
2013-08-17 00:00:00,11,12,25,32,44,45,23,192
2013-08-24 00:00:00,1,4,20,23,29,45,28,150
2013-08-31 00:00:00,5,7,18,37,42,45,20,174
2013-09-07 00:00:00,4,11,13,17,20,31,33,129
2013-09-14 00:00:00,5,10,16,17,31,32,21,132
2013-09-21 00:00:00,14,19,25,26,27,34,2,147
2013-09-28 00:00:00,4,10,18,27,40,45,38,182
2013-10-05 00:00:00,4,5,6,25,26,43,41,150
2013-10-12 00:00:00,1,10,15,16,32,41,28,143
2013-10-19 00:00:00,1,3,17,20,31,44,40,156
2013-10-26 00:00:00,3,6,13,23,24,35,1,105
2013-11-02 00:00:00,1,12,26,27,29,33,42,170
2013-11-09 00:00:00,11,18,21,26,38,43,29,186
2013-11-16 00:00:00,3,13,18,33,37,45,1,150
2013-11-23 00:00:00,2,4,20,34,35,43,14,152
2013-11-30 00:00:00,14,15,16,19,25,43,2,134
2013-12-07 00:00:00,2,8,20,30,33,34,6,133
2013-12-14 00:00:00,10,11,15,25,35,41,13,150
2013-12-21 00:00:00,16,17,22,31,34,37,33,190
2013-12-28 00:00:00,5,12,14,32,34,42,16,155
2014-01-04 00:00:00,5,7,20,22,37,42,39,172
2014-01-11 00:00:00,5,7,9,11,32,35,33,132
2014-01-18 00:00:00,3,5,14,20,42,44,33,161
2014-01-25 00:00:00,2,12,14,33,40,41,25,167
2014-02-01 00:00:00,8,17,27,33,40,44,24,193
2014-02-08 00:00:00,7,18,30,39,40,41,36,211
2014-02-15 00:00:00,6,7,10,16,38,41,4,122
2014-02-22 00:00:00,2,7,12,15,21,34,5,96
2014-03-01 00:00:00,14,21,29,31,32,37,17,181
2014-03-08 00:00:00,2,8,15,22,25,41,30,143
2014-03-15 00:00:00,6,8,28,33,38,39,22,174
2014-03-22 00:00:00,20,30,36,38,41,45,23,233
2014-03-29 00:00:00,8,13,14,30,38,39,5,147
2014-04-05 00:00:00,2,5,6,13,28,44,43,141
2014-04-12 00:00:00,9,10,13,24,33,38,28,155
2014-04-19 00:00:00,2,8,13,25,28,37,3,116
2014-04-26 00:00:00,8,24,28,35,38,40,5,178
2014-05-03 00:00:00,3,4,12,14,25,43,17,118
2014-05-10 00:00:00,8,10,23,24,35,43,37,180
2014-05-17 00:00:00,4,12,24,33,38,45,22,178
2014-05-24 00:00:00,5,12,17,29,34,35,27,159
2014-05-31 00:00:00,5,11,14,27,29,36,44,166
2014-06-07 00:00:00,2,16,19,31,34,35,37,174
2014-06-14 00:00:00,13,14,22,27,30,38,2,146
2014-06-21 00:00:00,2,19,25,26,27,43,28,170
2014-06-28 00:00:00,2,6,18,21,33,34,30,144
2014-07-05 00:00:00,1,2,7,9,10,38,42,109
2014-07-12 00:00:00,1,5,6,14,20,39,22,107
2014-07-19 00:00:00,8,14,23,36,38,39,13,171
2014-07-26 00:00:00,4,8,18,19,39,44,41,173
2014-08-02 00:00:00,4,8,27,34,39,40,13,165
2014-08-09 00:00:00,14,18,20,23,28,36,33,172
2014-08-16 00:00:00,2,22,27,33,36,37,14,171
2014-08-23 00:00:00,6,9,18,19,25,33,40,150
2014-08-30 00:00:00,7,8,11,16,41,44,35,162
2014-09-06 00:00:00,8,21,25,39,40,44,18,195
2014-09-13 00:00:00,10,17,18,19,23,27,35,149
2014-09-20 00:00:00,5,13,18,23,40,45,3,147
2014-09-27 00:00:00,4,5,11,12,24,27,28,111
2014-10-04 00:00:00,8,16,25,30,42,43,15,179
2014-10-11 00:00:00,6,8,13,30,35,40,21,153
2014-10-18 00:00:00,2,16,17,32,39,45,40,191
2014-10-25 00:00:00,1,2,6,16,19,42,9,95
2014-11-01 00:00:00,9,15,16,21,28,34,24,147
2014-11-08 00:00:00,7,13,30,39,41,45,25,200
2014-11-15 00:00:00,1,7,19,26,27,35,16,131
2014-11-22 00:00:00,3,6,7,20,21,39,13,109
2014-11-29 00:00:00,13,14,26,33,40,43,15,184
2014-12-06 00:00:00,2,9,22,25,31,45,12,146
2014-12-13 00:00:00,1,7,12,15,23,42,11,111
2014-12-20 00:00:00,19,28,31,38,43,44,1,204
2014-12-27 00:00:00,8,17,21,24,27,31,15,143
2015-01-03 00:00:00,1,2,4,23,31,34,8,103
2015-01-10 00:00:00,15,18,21,32,35,44,6,171
2015-01-17 00:00:00,9,12,19,20,39,41,13,153
2015-01-24 00:00:00,4,10,11,12,20,27,38,122
2015-01-31 00:00:00,11,13,25,26,29,33,32,169
2015-02-07 00:00:00,6,7,15,16,20,31,26,121
2015-02-14 00:00:00,3,16,22,37,38,44,23,183
2015-02-21 00:00:00,7,18,22,24,31,34,6,142
2015-02-28 00:00:00,6,15,22,23,25,32,40,163
2015-03-07 00:00:00,14,15,18,21,26,35,23,152
2015-03-14 00:00:00,11,18,21,36,37,43,12,178
2015-03-21 00:00:00,8,17,18,24,39,45,32,183
2015-03-28 00:00:00,15,24,31,32,33,40,13,188
2015-04-04 00:00:00,5,13,17,23,28,36,8,130
2015-04-11 00:00:00,1,4,16,26,40,41,31,159
2015-04-18 00:00:00,2,9,24,41,43,45,30,194
2015-04-25 00:00:00,5,16,21,23,24,30,29,148
2015-05-02 00:00:00,13,19,28,37,38,43,4,182
2015-05-09 00:00:00,3,21,22,33,41,42,20,182
2015-05-16 00:00:00,3,4,7,11,31,41,35,132
2015-05-23 00:00:00,11,12,16,26,29,44,18,156
2015-05-30 00:00:00,3,13,15,40,41,44,20,176
2015-06-06 00:00:00,5,6,26,27,38,39,1,142
2015-06-13 00:00:00,16,21,26,31,36,43,6,179
2015-06-20 00:00:00,7,37,38,39,40,44,18,223
2015-06-27 00:00:00,3,7,14,16,31,40,39,150
2015-07-04 00:00:00,10,14,19,39,40,43,23,188
2015-07-11 00:00:00,8,19,25,28,32,36,37,185
2015-07-18 00:00:00,7,18,19,27,29,42,45,187
2015-07-25 00:00:00,4,9,23,33,39,44,14,166
2015-08-01 00:00:00,2,3,12,20,27,38,40,142
2015-08-08 00:00:00,5,6,9,11,15,37,26,109
2015-08-15 00:00:00,3,5,8,19,38,42,20,135
2015-08-22 00:00:00,10,20,33,36,41,44,5,189
2015-08-29 00:00:00,5,6,11,17,38,44,13,134
2015-09-05 00:00:00,2,4,6,11,17,28,16,84
2015-09-12 00:00:00,15,17,25,37,42,43,13,192
2015-09-19 00:00:00,12,14,15,24,27,32,3,127
2015-09-26 00:00:00,7,8,20,29,33,38,9,144
2015-10-03 00:00:00,11,18,26,27,40,41,25,188
2015-10-10 00:00:00,7,9,10,13,31,35,24,129
2015-10-17 00:00:00,8,21,28,31,36,45,43,212
2015-10-24 00:00:00,7,10,17,29,33,44,5,145
2015-10-31 00:00:00,9,10,14,25,27,31,11,127
2015-11-07 00:00:00,1,8,11,15,18,45,7,105
2015-11-14 00:00:00,1,8,17,34,39,45,27,171
2015-11-21 00:00:00,12,15,24,36,41,44,42,214
2015-11-28 00:00:00,4,5,6,12,25,37,45,134
2015-12-05 00:00:00,3,5,7,14,26,34,35,124
2015-12-12 00:00:00,4,10,19,29,32,42,30,166
2015-12-19 00:00:00,21,24,27,29,43,44,7,195
2015-12-26 00:00:00,17,23,27,35,38,43,2,185
2016-01-02 00:00:00,6,13,20,27,28,40,15,149
2016-01-09 00:00:00,1,11,15,17,25,39,40,148
2016-01-16 00:00:00,6,7,12,28,38,40,18,149
2016-01-23 00:00:00,7,12,15,24,25,43,13,139
2016-01-30 00:00:00,1,8,10,13,28,42,45,147
2016-02-06 00:00:00,5,15,22,23,34,35,2,136
2016-02-13 00:00:00,7,17,19,30,36,38,34,181
2016-02-20 00:00:00,24,25,33,34,38,39,43,236
2016-02-27 00:00:00,15,27,33,35,43,45,16,214
2016-03-05 00:00:00,3,11,14,15,32,36,44,155
2016-03-12 00:00:00,1,6,11,28,34,42,30,152
2016-03-19 00:00:00,7,15,20,25,33,43,12,155
2016-03-26 00:00:00,4,18,26,33,34,38,14,167
2016-04-02 00:00:00,1,7,16,18,34,38,21,135
2016-04-09 00:00:00,2,5,8,11,33,39,31,129
2016-04-16 00:00:00,3,11,13,21,33,37,18,136
2016-04-23 00:00:00,4,5,8,16,21,29,3,86
2016-04-30 00:00:00,11,23,28,29,30,44,13,178
2016-05-07 00:00:00,3,10,14,16,36,38,35,152
2016-05-14 00:00:00,3,13,16,24,26,29,9,120
2016-05-21 00:00:00,10,28,31,33,41,44,21,208
2016-05-28 00:00:00,1,4,8,23,33,42,45,156
2016-06-04 00:00:00,1,6,17,22,28,45,23,142
2016-06-11 00:00:00,3,4,6,10,28,30,37,118
2016-06-18 00:00:00,2,12,19,24,39,44,35,175
2016-06-25 00:00:00,2,10,16,19,34,45,1,127
2016-07-02 00:00:00,10,18,30,36,39,44,32,209
2016-07-09 00:00:00,3,4,9,24,25,33,10,108
2016-07-16 00:00:00,11,15,24,35,37,45,42,209
2016-07-23 00:00:00,17,20,30,31,33,45,19,195
2016-07-30 00:00:00,2,5,15,18,19,23,44,126
2016-08-06 00:00:00,1,7,22,33,37,40,20,160
2016-08-13 00:00:00,2,7,27,33,41,44,10,164
2016-08-20 00:00:00,2,6,13,16,29,30,21,117
2016-08-27 00:00:00,2,11,19,25,28,32,44,161
2016-09-03 00:00:00,4,11,20,23,32,39,40,169
2016-09-10 00:00:00,4,8,13,19,20,43,26,133
2016-09-17 00:00:00,1,12,29,34,36,37,41,190
2016-09-24 00:00:00,1,28,35,41,43,44,31,223
2016-10-01 00:00:00,12,14,21,30,39,43,45,204
2016-10-08 00:00:00,20,30,33,35,36,44,22,220
2016-10-15 00:00:00,2,8,33,35,37,41,14,170
2016-10-22 00:00:00,6,7,19,21,41,43,38,175
2016-10-29 00:00:00,1,11,21,23,34,44,24,158
2016-11-05 00:00:00,7,8,10,19,21,31,20,116
2016-11-12 00:00:00,3,6,10,30,34,37,36,156
2016-11-19 00:00:00,11,17,21,26,36,45,16,172
2016-11-26 00:00:00,4,10,14,15,18,22,39,122
2016-12-03 00:00:00,2,7,13,25,42,45,39,173
2016-12-10 00:00:00,2,4,5,17,27,32,43,130
2016-12-17 00:00:00,11,24,32,33,35,40,13,188
2016-12-24 00:00:00,6,16,37,38,41,45,18,201
2016-12-31 00:00:00,5,10,13,27,37,41,4,137
2017-01-07 00:00:00,2,11,17,18,21,27,6,102
2017-01-14 00:00:00,13,15,18,24,27,41,11,149
2017-01-21 00:00:00,23,27,28,38,42,43,36,237
2017-01-28 00:00:00,7,22,29,33,34,35,30,190
2017-02-04 00:00:00,4,8,9,16,17,19,31,104
2017-02-11 00:00:00,5,21,27,34,44,45,16,192
2017-02-18 00:00:00,8,10,13,36,37,40,6,150
2017-02-25 00:00:00,15,19,21,34,41,44,10,184
2017-03-04 00:00:00,10,15,18,21,34,41,43,182
2017-03-11 00:00:00,1,2,3,9,12,23,10,60
2017-03-18 00:00:00,3,12,33,36,42,45,25,196
2017-03-25 00:00:00,7,9,12,14,23,28,17,110
2017-04-01 00:00:00,3,10,13,22,31,32,29,140
2017-04-08 00:00:00,12,14,24,26,34,45,41,196
2017-04-15 00:00:00,1,2,15,19,24,36,12,109
2017-04-22 00:00:00,3,4,16,20,28,44,17,132
2017-04-29 00:00:00,4,16,20,33,40,43,7,163
2017-05-06 00:00:00,2,17,19,24,37,41,3,143
2017-05-13 00:00:00,2,8,17,24,29,31,32,143
2017-05-20 00:00:00,13,14,26,28,30,36,37,184
2017-05-27 00:00:00,10,14,16,18,27,28,4,117
2017-06-03 00:00:00,6,7,11,17,33,44,1,119
2017-06-10 00:00:00,5,9,12,30,39,43,24,162
2017-06-17 00:00:00,9,33,36,40,42,43,32,235
2017-06-24 00:00:00,10,22,27,31,42,43,12,187
2017-07-01 00:00:00,4,7,11,24,42,45,30,163
2017-07-08 00:00:00,1,3,12,21,26,41,16,120
2017-07-15 00:00:00,3,8,16,32,34,43,10,146
2017-07-22 00:00:00,7,22,24,31,34,36,15,169
2017-07-29 00:00:00,1,3,8,12,42,43,33,142
2017-08-05 00:00:00,9,30,34,35,39,41,21,209
2017-08-12 00:00:00,5,15,20,31,34,42,22,169
2017-08-19 00:00:00,7,27,29,30,38,44,4,179
2017-08-26 00:00:00,5,7,11,16,41,45,4,129
2017-09-02 00:00:00,1,9,12,23,39,43,34,161
2017-09-09 00:00:00,6,10,17,18,21,29,30,131
2017-09-16 00:00:00,5,6,11,14,21,41,32,130
2017-09-23 00:00:00,8,12,19,21,31,35,44,170
2017-09-30 00:00:00,12,15,18,28,34,42,9,158
2017-10-07 00:00:00,11,12,29,33,38,42,17,182
2017-10-14 00:00:00,8,9,18,21,28,40,20,144
2017-10-21 00:00:00,6,12,17,21,34,37,18,145
2017-10-28 00:00:00,6,21,35,36,37,41,11,187
2017-11-04 00:00:00,6,12,19,24,34,41,4,140
2017-11-11 00:00:00,15,17,19,21,27,45,16,160
2017-11-18 00:00:00,11,16,18,19,24,39,43,170
2017-11-25 00:00:00,6,18,31,34,38,45,20,192
2017-12-02 00:00:00,14,15,16,17,38,45,36,181
2017-12-09 00:00:00,3,10,23,24,31,39,22,152
2017-12-16 00:00:00,4,6,15,25,26,33,40,149
2017-12-23 00:00:00,12,15,16,20,24,30,38,155
2017-12-30 00:00:00,5,6,13,16,27,28,9,104
2018-01-06 00:00:00,2,10,11,19,35,39,29,145
2018-01-13 00:00:00,2,6,7,12,19,45,38,129
2018-01-20 00:00:00,3,8,19,27,30,41,12,140
2018-01-27 00:00:00,2,10,12,31,33,42,32,162
2018-02-03 00:00:00,2,7,19,25,29,36,16,134
2018-02-10 00:00:00,10,15,21,35,38,43,31,193
2018-02-17 00:00:00,6,7,18,19,30,38,13,131
2018-02-24 00:00:00,3,10,13,26,34,38,36,160
2018-03-03 00:00:00,1,21,26,36,40,41,5,170
2018-03-10 00:00:00,5,22,31,32,39,45,36,210
2018-03-17 00:00:00,2,10,14,22,32,36,41,157
2018-03-24 00:00:00,12,17,23,34,42,45,33,206
2018-03-31 00:00:00,1,4,10,12,28,45,26,126
2018-04-07 00:00:00,17,25,28,37,43,44,2,196
2018-04-14 00:00:00,10,11,12,18,24,42,27,144
2018-04-21 00:00:00,5,9,14,26,30,43,2,129
2018-04-28 00:00:00,1,10,13,26,32,36,9,127
2018-05-05 00:00:00,3,12,13,18,31,32,42,151
2018-05-12 00:00:00,14,20,23,31,37,38,27,190
2018-05-19 00:00:00,6,10,18,25,34,35,33,161
2018-05-26 00:00:00,15,21,31,32,41,43,24,207
2018-06-02 00:00:00,6,11,15,17,23,40,39,151
2018-06-09 00:00:00,5,10,13,21,39,43,11,142
2018-06-16 00:00:00,8,11,19,21,36,45,25,165
2018-06-23 00:00:00,1,3,12,14,16,43,10,99
2018-06-30 00:00:00,11,30,34,35,42,44,27,223
2018-07-07 00:00:00,2,21,28,38,42,45,30,206
2018-07-14 00:00:00,17,21,25,26,27,36,4,156
2018-07-21 00:00:00,12,18,19,29,31,39,7,155
2018-07-28 00:00:00,3,9,12,13,25,43,34,139
2018-08-04 00:00:00,14,15,25,28,29,30,3,144
2018-08-11 00:00:00,16,25,33,38,40,45,15,212
2018-08-18 00:00:00,10,21,22,30,35,42,6,166
2018-08-25 00:00:00,1,12,13,24,29,44,16,139
2018-09-01 00:00:00,9,18,20,24,27,36,12,146
2018-09-08 00:00:00,12,18,24,26,39,40,15,174
2018-09-15 00:00:00,7,9,24,29,34,38,26,167
2018-09-22 00:00:00,8,15,21,31,33,38,42,188
2018-09-29 00:00:00,13,16,24,25,33,36,42,189
2018-10-06 00:00:00,5,11,12,29,33,44,14,148
2018-10-13 00:00:00,4,7,13,29,31,39,18,141
2018-10-20 00:00:00,4,5,31,35,43,45,29,192
2018-10-27 00:00:00,5,6,16,18,37,38,17,137
2018-11-03 00:00:00,3,10,16,19,31,39,9,127
2018-11-10 00:00:00,13,14,19,26,40,43,30,185
2018-11-17 00:00:00,12,18,30,39,41,42,19,201
2018-11-24 00:00:00,6,8,18,35,42,43,3,155
2018-12-01 00:00:00,9,10,13,28,38,45,35,178
2018-12-08 00:00:00,1,9,11,14,26,28,19,108
2018-12-15 00:00:00,2,25,28,30,33,45,6,169
2018-12-22 00:00:00,9,14,17,33,36,38,20,167
2018-12-29 00:00:00,3,9,11,12,13,19,35,102
2019-01-05 00:00:00,2,4,11,28,29,43,27,144
2019-01-12 00:00:00,5,11,14,30,33,38,24,155
2019-01-19 00:00:00,14,26,32,36,39,42,38,227
2019-01-26 00:00:00,19,21,30,33,34,42,4,183
2019-02-02 00:00:00,7,8,13,15,33,45,18,139
2019-02-09 00:00:00,1,16,29,33,40,45,6,170
2019-02-16 00:00:00,5,18,30,41,43,45,13,195
2019-02-23 00:00:00,12,16,26,28,30,42,22,176
2019-03-02 00:00:00,1,2,16,22,38,39,34,152
2019-03-09 00:00:00,5,13,17,29,34,39,3,140
2019-03-16 00:00:00,16,20,24,28,36,39,5,168
2019-03-23 00:00:00,14,18,22,26,31,44,40,195
2019-03-30 00:00:00,11,17,28,30,33,35,9,163
2019-04-06 00:00:00,2,8,23,26,27,44,13,143
2019-04-13 00:00:00,20,25,31,32,36,43,3,190
2019-04-20 00:00:00,8,15,17,19,43,44,7,153
2019-04-27 00:00:00,10,24,40,41,43,44,17,219
2019-05-04 00:00:00,6,10,16,28,34,38,43,175
2019-05-11 00:00:00,9,13,32,38,39,43,23,197
2019-05-18 00:00:00,8,22,35,38,39,41,24,207
2019-05-25 00:00:00,4,8,18,25,27,32,42,156
2019-06-01 00:00:00,11,17,19,21,22,25,24,139
2019-06-08 00:00:00,10,34,38,40,42,43,32,239
2019-06-15 00:00:00,16,21,28,35,39,43,12,194
2019-06-22 00:00:00,3,7,10,13,25,36,32,126
2019-06-29 00:00:00,3,15,22,32,33,45,2,152
2019-07-06 00:00:00,9,15,29,34,37,39,12,175
2019-07-13 00:00:00,14,17,19,22,24,40,41,177
2019-07-20 00:00:00,12,17,28,41,43,44,25,210
2019-07-27 00:00:00,2,6,20,27,37,39,4,135
2019-08-03 00:00:00,21,25,30,32,40,42,31,221
2019-08-10 00:00:00,2,6,12,26,30,34,38,148
2019-08-17 00:00:00,2,4,30,32,33,43,29,173
2019-08-24 00:00:00,3,5,12,13,33,39,38,143
2019-08-31 00:00:00,1,15,19,23,28,42,32,160
2019-09-07 00:00:00,19,22,30,34,39,44,36,224
2019-09-14 00:00:00,5,16,21,26,34,42,24,168
2019-09-21 00:00:00,5,17,18,22,23,43,12,140
2019-09-28 00:00:00,2,6,11,16,25,31,3,94
2019-10-05 00:00:00,1,4,10,14,15,35,20,99
2019-10-12 00:00:00,7,17,19,23,24,45,38,173
2019-10-19 00:00:00,4,18,20,26,27,32,9,136
2019-10-26 00:00:00,18,34,39,43,44,45,23,246
2019-11-02 00:00:00,9,18,32,33,37,44,22,195
2019-11-09 00:00:00,4,14,23,28,37,45,17,168
2019-11-16 00:00:00,1,3,24,27,39,45,31,170
2019-11-23 00:00:00,19,23,28,37,42,45,2,196
2019-11-30 00:00:00,8,14,17,27,36,45,10,157
2019-12-07 00:00:00,3,7,12,31,34,38,32,157
2019-12-14 00:00:00,3,13,29,38,39,42,26,190
2019-12-21 00:00:00,1,4,14,18,29,37,6,109
2019-12-28 00:00:00,9,13,28,31,39,41,19,180
2020-01-04 00:00:00,4,9,17,18,26,42,36,152
2020-01-11 00:00:00,1,15,17,23,25,41,10,132
2020-01-18 00:00:00,19,32,37,40,41,43,45,257
2020-01-25 00:00:00,16,26,31,38,39,41,23,214
2020-02-01 00:00:00,5,12,25,26,38,45,23,174
2020-02-08 00:00:00,6,7,12,22,26,36,29,138
2020-02-15 00:00:00,18,21,28,35,37,42,17,198
2020-02-22 00:00:00,8,19,20,21,33,39,37,177
2020-02-29 00:00:00,7,13,16,18,35,38,14,141
2020-03-07 00:00:00,5,18,20,23,30,34,21,151
2020-03-14 00:00:00,7,19,23,24,36,39,30,178
2020-03-21 00:00:00,2,15,16,21,22,28,45,149
2020-03-28 00:00:00,2,6,8,26,43,45,11,141
2020-04-04 00:00:00,3,4,16,27,38,40,20,148
2020-04-11 00:00:00,2,5,14,28,31,32,20,132
2020-04-18 00:00:00,21,27,29,38,40,44,37,236
2020-04-25 00:00:00,3,16,21,22,23,44,30,159
2020-05-02 00:00:00,7,24,29,30,34,35,33,192
2020-05-09 00:00:00,1,11,17,27,35,39,31,161
2020-05-16 00:00:00,4,5,12,14,32,42,35,144
2020-05-23 00:00:00,5,8,18,21,22,38,10,122
2020-05-30 00:00:00,6,14,16,21,27,37,40,161
2020-06-06 00:00:00,16,19,24,33,42,44,27,205
2020-06-13 00:00:00,2,6,11,13,22,37,14,105
2020-06-20 00:00:00,6,21,22,32,35,36,17,169
2020-06-27 00:00:00,1,3,23,24,27,43,34,155
2020-07-04 00:00:00,7,11,12,31,33,38,5,137
2020-07-11 00:00:00,9,14,17,18,42,44,35,179
2020-07-18 00:00:00,2,3,26,33,34,43,29,170
2020-07-25 00:00:00,5,7,12,22,28,41,1,116
2020-08-01 00:00:00,2,6,13,17,27,43,36,144
2020-08-08 00:00:00,3,17,18,23,36,41,26,164
2020-08-15 00:00:00,3,11,34,42,43,44,13,190
2020-08-22 00:00:00,13,24,32,34,39,42,4,188
2020-08-29 00:00:00,10,16,18,20,25,31,6,126
2020-09-05 00:00:00,4,15,22,38,41,43,26,189
2020-09-12 00:00:00,3,4,10,20,28,44,30,139
2020-09-19 00:00:00,7,9,12,15,19,23,4,89
2020-09-26 00:00:00,8,21,25,38,39,44,28,203
2020-10-03 00:00:00,14,15,23,25,35,43,32,187
2020-10-10 00:00:00,1,6,15,36,37,38,5,138
2020-10-17 00:00:00,23,27,29,31,36,45,37,228
2020-10-24 00:00:00,1,3,30,33,36,39,12,154
2020-10-31 00:00:00,4,10,20,32,38,44,18,166
2020-11-07 00:00:00,7,11,13,17,18,29,43,138
2020-11-14 00:00:00,2,10,13,22,29,40,26,142
2020-11-21 00:00:00,4,8,10,16,31,36,9,114
2020-11-28 00:00:00,4,11,28,39,42,45,6,175
2020-12-05 00:00:00,3,15,20,22,24,41,11,136
2020-12-12 00:00:00,12,14,25,27,39,40,35,192
2020-12-19 00:00:00,10,12,18,35,42,43,39,199
2020-12-26 00:00:00,1,8,13,36,44,45,39,186
2021-01-02 00:00:00,2,13,16,19,32,33,42,157
2021-01-09 00:00:00,9,10,15,30,33,37,26,160
2021-01-16 00:00:00,9,18,19,30,34,40,20,170
2021-01-23 00:00:00,3,8,17,20,27,35,26,136
2021-01-30 00:00:00,13,18,30,31,38,41,5,176
2021-02-06 00:00:00,14,21,35,36,40,44,30,220
2021-02-13 00:00:00,3,4,15,22,28,40,10,122
2021-02-20 00:00:00,2,12,30,31,39,43,38,195
2021-02-27 00:00:00,4,12,22,24,33,41,38,174
2021-03-06 00:00:00,7,9,22,27,37,42,34,178
2021-03-13 00:00:00,1,9,26,28,30,41,32,167
2021-03-20 00:00:00,4,9,23,26,29,33,8,132
2021-03-27 00:00:00,10,11,20,21,25,41,40,168
2021-04-03 00:00:00,4,15,24,35,36,40,1,155
2021-04-10 00:00:00,2,9,10,16,35,37,1,110
2021-04-17 00:00:00,1,14,15,24,40,41,35,170
2021-04-24 00:00:00,2,18,24,30,32,45,14,165
2021-05-01 00:00:00,11,20,29,31,33,42,43,209
2021-05-08 00:00:00,1,18,28,31,34,43,40,195
2021-05-15 00:00:00,6,12,19,23,34,42,35,171
2021-05-22 00:00:00,6,21,36,38,39,43,30,213
2021-05-29 00:00:00,2,13,25,28,29,36,34,167
2021-06-05 00:00:00,1,21,25,29,34,37,36,183
2021-06-12 00:00:00,1,6,13,37,38,40,9,144
2021-06-19 00:00:00,2,5,12,14,24,39,33,129
2021-06-26 00:00:00,3,9,10,29,40,45,7,143
2021-07-03 00:00:00,9,11,16,21,28,36,5,126
2021-07-10 00:00:00,2,6,17,18,21,26,7,97
2021-07-17 00:00:00,3,6,17,23,37,39,26,151
2021-07-24 00:00:00,22,26,31,37,41,42,24,223
2021-07-31 00:00:00,1,2,11,16,39,44,32,145
2021-08-07 00:00:00,7,8,9,17,22,24,5,92
2021-08-14 00:00:00,4,12,14,25,35,37,2,129
2021-08-21 00:00:00,2,9,10,14,22,44,16,117
2021-08-28 00:00:00,1,7,15,32,34,42,8,139
2021-09-04 00:00:00,7,11,16,21,27,33,24,139
2021-09-11 00:00:00,3,13,16,23,24,35,14,128
2021-09-18 00:00:00,27,36,37,41,43,45,32,261
2021-09-25 00:00:00,5,7,13,20,21,44,33,143
2021-10-02 00:00:00,13,23,26,31,35,43,15,186
2021-10-09 00:00:00,3,10,23,35,36,37,18,162
2021-10-16 00:00:00,17,21,23,30,34,44,19,188
2021-10-23 00:00:00,7,10,16,28,41,42,40,184
2021-10-30 00:00:00,2,4,15,23,29,38,7,118
2021-11-06 00:00:00,2,13,20,30,31,41,27,164
2021-11-13 00:00:00,17,18,21,27,29,33,26,171
2021-11-20 00:00:00,2,4,25,26,36,37,28,158
2021-11-27 00:00:00,13,18,25,31,33,44,38,202
2021-12-04 00:00:00,12,20,26,33,44,45,24,204
2021-12-11 00:00:00,6,14,16,18,24,42,44,164
2021-12-18 00:00:00,1,3,8,24,27,35,28,126
2021-12-25 00:00:00,1,4,13,29,38,39,7,131
2022-01-01 00:00:00,6,11,15,24,32,39,28,155
2022-01-08 00:00:00,4,7,14,16,24,44,20,129
2022-01-15 00:00:00,13,17,18,20,42,45,41,196
2022-01-22 00:00:00,1,3,9,14,18,28,34,107
2022-01-29 00:00:00,2,8,19,22,32,42,39,164
2022-02-05 00:00:00,6,10,12,14,20,42,15,119
2022-02-12 00:00:00,17,25,33,35,38,45,15,208
2022-02-19 00:00:00,1,4,29,39,43,45,31,192
2022-02-26 00:00:00,7,15,30,37,39,44,18,190
2022-03-05 00:00:00,8,13,18,24,27,29,17,136
2022-03-12 00:00:00,8,11,15,16,17,37,36,140
2022-03-19 00:00:00,8,11,16,19,21,25,40,140
2022-03-26 00:00:00,9,11,30,31,41,44,33,199
2022-04-02 00:00:00,15,23,29,34,40,44,20,205
2022-04-09 00:00:00,9,12,15,25,34,36,3,134
2022-04-16 00:00:00,1,9,12,26,35,38,42,163
2022-04-23 00:00:00,5,11,18,20,35,45,3,137
2022-04-30 00:00:00,21,22,26,34,36,41,32,212
2022-05-07 00:00:00,3,11,14,18,26,27,21,120
2022-05-14 00:00:00,14,23,31,33,37,40,44,222
2022-05-21 00:00:00,15,26,28,34,41,42,44,230
2022-05-28 00:00:00,12,18,22,23,30,34,32,171
2022-06-04 00:00:00,3,19,21,25,37,45,35,185
2022-06-11 00:00:00,1,4,13,17,34,39,6,114
2022-06-18 00:00:00,12,27,29,38,41,45,6,198
2022-06-25 00:00:00,12,15,17,24,29,45,16,158
2022-07-02 00:00:00,5,6,11,29,42,45,28,166
2022-07-09 00:00:00,10,14,16,18,29,35,25,147
2022-07-16 00:00:00,9,18,20,22,38,44,10,161
2022-07-23 00:00:00,8,9,20,25,29,33,7,131
2022-07-30 00:00:00,5,12,13,31,32,41,34,168
2022-08-06 00:00:00,14,16,27,35,39,45,5,181
2022-08-13 00:00:00,5,7,12,13,18,35,23,113
2022-08-20 00:00:00,12,30,32,37,39,41,24,215
2022-08-27 00:00:00,2,5,11,17,24,29,9,97
2022-09-03 00:00:00,6,7,22,32,35,36,19,157
2022-09-10 00:00:00,1,6,12,19,36,42,28,144
2022-09-17 00:00:00,3,11,15,20,35,44,10,138
2022-09-24 00:00:00,26,31,32,33,38,40,11,211
2022-10-01 00:00:00,9,14,34,35,41,42,2,177
2022-10-08 00:00:00,2,5,22,32,34,45,39,179
2022-10-15 00:00:00,2,14,15,22,27,33,31,144
2022-10-22 00:00:00,7,16,24,27,37,44,2,157
2022-10-29 00:00:00,2,3,6,19,36,39,26,131
2022-11-05 00:00:00,8,16,26,29,31,36,11,157
2022-11-12 00:00:00,6,7,9,11,17,18,45,113
2022-11-19 00:00:00,5,14,15,23,34,43,4,138
2022-11-26 00:00:00,3,5,12,22,26,31,19,118
2022-12-03 00:00:00,12,17,20,26,28,36,4,143
2022-12-10 00:00:00,6,14,15,19,21,41,37,153
2022-12-17 00:00:00,7,16,25,29,35,36,28,176
2022-12-24 00:00:00,2,20,33,40,42,44,32,213
2022-12-31 00:00:00,6,12,17,21,32,39,30,157
2023-01-07 00:00:00,3,5,13,20,21,37,17,116
2023-01-14 00:00:00,6,12,31,35,38,43,17,182
2023-01-21 00:00:00,21,26,30,32,33,35,44,221
2023-01-28 00:00:00,5,17,26,27,35,38,1,149
2023-02-04 00:00:00,22,26,29,30,34,45,15,201
2023-02-11 00:00:00,14,19,27,28,30,45,33,196
2023-02-18 00:00:00,4,7,12,14,22,33,31,123
2023-02-25 00:00:00,13,20,24,32,36,45,29,199
2023-03-04 00:00:00,8,13,19,27,40,45,12,164
2023-03-11 00:00:00,11,23,25,30,32,40,42,203
2023-03-18 00:00:00,7,10,22,25,34,40,27,165
2023-03-25 00:00:00,3,10,24,33,38,45,36,189
2023-04-01 00:00:00,4,24,27,35,37,45,15,187
2023-04-08 00:00:00,20,31,32,40,41,45,12,221
2023-04-15 00:00:00,3,6,22,23,24,38,30,146
2023-04-22 00:00:00,3,6,9,18,22,35,14,107
2023-04-29 00:00:00,3,18,19,23,32,45,24,164
2023-05-06 00:00:00,6,11,16,19,21,32,45,150
2023-05-13 00:00:00,7,10,19,23,28,33,18,138
2023-05-20 00:00:00,4,7,19,26,33,35,3,127
2023-05-27 00:00:00,1,10,18,22,28,31,44,154
2023-06-03 00:00:00,3,6,14,22,30,41,36,152
2023-06-10 00:00:00,1,2,11,21,30,35,39,139
2023-06-17 00:00:00,16,18,20,23,32,43,27,179
2023-06-24 00:00:00,6,18,28,30,32,38,15,167
2023-07-01 00:00:00,1,6,20,27,28,41,15,138
2023-07-08 00:00:00,1,23,24,35,44,45,10,182
2023-07-15 00:00:00,3,7,9,33,36,37,10,135
2023-07-22 00:00:00,4,8,17,30,40,43,34,176
2023-07-29 00:00:00,6,10,11,14,36,38,43,158
2023-08-05 00:00:00,4,8,18,24,37,45,6,142
2023-08-12 00:00:00,13,16,23,31,36,44,38,201
2023-08-19 00:00:00,1,9,16,23,24,38,17,128
2023-08-26 00:00:00,21,26,27,32,34,42,31,213
2023-09-02 00:00:00,3,7,14,15,22,38,17,116
2023-09-09 00:00:00,8,12,13,29,33,42,5,142
2023-09-16 00:00:00,4,7,17,18,38,44,36,164
2023-09-23 00:00:00,11,16,25,27,35,36,37,187
2023-09-30 00:00:00,13,14,18,21,34,44,16,160
2023-10-07 00:00:00,11,21,22,30,39,44,31,198
2023-10-14 00:00:00,4,18,31,37,42,43,40,215
2023-10-21 00:00:00,12,19,21,29,40,45,1,167
2023-10-28 00:00:00,6,20,23,24,28,30,44,175
2023-11-04 00:00:00,7,18,19,26,33,45,37,185
2023-11-11 00:00:00,10,17,22,30,35,43,44,201
2023-11-18 00:00:00,6,7,15,22,26,40,41,157
2023-11-25 00:00:00,8,14,28,29,34,40,12,165
2023-12-02 00:00:00,1,12,16,19,23,43,34,148
